[
    "8781",
    "10324",
    "11831",
    "12086",
    "12087",
    "12342",
    "12343",
    "12348",
    "12599",
    "12855",
    "13111"
]
